SO ./img/north_texture.xpm
WE ./img/north_texture.xpm
EA ./img/north_texture.xpm
NO ./img/north_texture.xpm


C 205,249,255
F 157,157,157


    1
1111N1111
111111111

