SO ./img/south_texture.xpm
WE ./img/west_texture.xpm
EA ./img/east_texture.xpm
NO ./img/north_texture.xpm


C 205,249,255
F 157,157,157

111111
100001
100001
100101
1N0001
111111


        1000000000110000000000001
        1011000001110000000000001
        1001000000000000000000001
111111111011000001110000000000001
100000000011000001110111111111111
11110111111111011100000010001
11110111111111011101010010001
11000000110101011100000010001
10000000000000001100000010001
10000000000000001101010010001
11000001110101011111011110N0111
11110111 1110101 101111010001
11111111 1111111 111111111111