SO ./img/north_texture.xpm
WE ./img/north_texture.xpm
EA ./img/north_texture.xpm
NO ./img/north_texture.xpm


C 205,249,255
F 157,157,157

111111
1N1
111