SO ./img/north_texture.xpm
WE ./img/north_texture.xpm
EA ./img/north_texture.xpm
NO ../img/north_texture.xpm


F 220,100,0
C 225,30,0


111111111
1111W1111
111111111

