SO ./img/north_texture.xpm
WE ./img/north_texture.xpm
EA ./img/north_texture.xpm
NO ./img/north_texture.xpm


C 205,249,255
F 157,157,157

111111111111111
100000000000001
100000000100001
100000000000001
1000000N0000001
111111111111111